amy|Amy
ansel|Ansel
autumn|Autumn
ava|Ava
brandon|Brandon
caleb|Caleb
cassian|Cassian
chloe|Chloe
dalton|Dalton
daniel|Daniel
dustin|Dustin
elowen|Elowen
evander|Evander
huxley|Huxley
james|James
juniper|Juniper
kennedy|Kennedy
lauren|Lauren
leah|Leah
lily|Lily
lucas|Lucas
magnus|Magnus
miles|Miles
morgan|Morgan
natalie|Natalie
nathan|Nathan
noah|Noah
nyssa|Nyssa
oliver|Oliver
paige|Paige
ryan|Ryan
sadie|Sadie
sophie|Sophie
stella|Stella
terrence|Terrence
tyler|Tyler
vesper|Vesper
violet|Violet
warrick|Warrick
zain|Zain
zeke|Zeke
zoe|Zoe
